a1,a2,a3,a4,a5,class
107.0,10.1,2.2,0.9,2.7,b'1'
113.0,9.9,3.1,2.0,5.9,b'1'
127.0,12.9,2.4,1.4,0.6,b'1'
109.0,5.3,1.6,1.4,1.5,b'1'
105.0,7.3,1.5,1.5,-0.1,b'1'
105.0,6.1,2.1,1.4,7.0,b'1'
110.0,10.4,1.6,1.6,2.7,b'1'
114.0,9.9,2.4,1.5,5.7,b'1'
106.0,9.4,2.2,1.5,0.0,b'1'
107.0,13.0,1.1,0.9,3.1,b'1'
106.0,4.2,1.2,1.6,1.4,b'1'
110.0,11.3,2.3,0.9,3.3,b'1'
116.0,9.2,2.7,1.0,4.2,b'1'
112.0,8.1,1.9,3.7,2.0,b'1'
122.0,9.7,1.6,0.9,2.2,b'1'
109.0,8.4,2.1,1.1,3.6,b'1'
111.0,8.4,1.5,0.8,1.2,b'1'
114.0,6.7,1.5,1.0,3.5,b'1'
119.0,10.6,2.1,1.3,1.1,b'1'
115.0,7.1,1.3,1.3,2.0,b'1'
101.0,7.8,1.2,1.0,1.7,b'1'
103.0,10.1,1.3,0.7,0.1,b'1'
109.0,10.4,1.9,0.4,-0.1,b'1'
102.0,7.6,1.8,2.0,2.5,b'1'
121.0,10.1,1.7,1.3,0.1,b'1'
100.0,6.1,2.4,1.8,3.8,b'1'
106.0,9.6,2.4,1.0,1.3,b'1'
116.0,10.1,2.2,1.6,0.8,b'1'
105.0,11.1,2.0,1.0,1.0,b'1'
110.0,10.4,1.8,1.0,2.3,b'1'
120.0,8.4,1.1,1.4,1.4,b'1'
116.0,11.1,2.0,1.2,2.3,b'1'
110.0,7.8,1.9,2.1,6.4,b'1'
90.0,8.1,1.6,1.4,1.1,b'1'
117.0,12.2,1.9,1.2,3.9,b'1'
117.0,11.0,1.4,1.5,2.1,b'1'
113.0,9.0,2.0,1.8,1.6,b'1'
106.0,9.4,1.5,0.8,0.5,b'1'
130.0,9.5,1.7,0.4,3.2,b'1'
100.0,10.5,2.4,0.9,1.9,b'1'
121.0,10.1,2.4,0.8,3.0,b'1'
110.0,9.2,1.6,1.5,0.3,b'1'
129.0,11.9,2.7,1.2,3.5,b'1'
121.0,13.5,1.5,1.6,0.5,b'1'
123.0,8.1,2.3,1.0,5.1,b'1'
107.0,8.4,1.8,1.5,0.8,b'1'
109.0,10.0,1.3,1.8,4.3,b'1'
120.0,6.8,1.9,1.3,1.9,b'1'
100.0,9.5,2.5,1.3,-0.2,b'1'
118.0,8.1,1.9,1.5,13.7,b'1'
100.0,11.3,2.5,0.7,-0.3,b'1'
103.0,12.2,1.2,1.3,2.7,b'1'
115.0,8.1,1.7,0.6,2.2,b'1'
119.0,8.0,2.0,0.6,3.2,b'1'
106.0,9.4,1.7,0.9,3.1,b'1'
114.0,10.9,2.1,0.3,1.4,b'1'
93.0,8.9,1.5,0.8,2.7,b'1'
120.0,10.4,2.1,1.1,1.8,b'1'
106.0,11.3,1.8,0.9,1.0,b'1'
110.0,8.7,1.9,1.6,4.4,b'1'
103.0,8.1,1.4,0.5,3.8,b'1'
101.0,7.1,2.2,0.8,2.2,b'1'
115.0,10.4,1.8,1.6,2.0,b'1'
116.0,10.0,1.7,1.5,4.3,b'1'
117.0,9.2,1.9,1.5,6.8,b'1'
106.0,6.7,1.5,1.2,3.9,b'1'
118.0,10.5,2.1,0.7,3.5,b'1'
97.0,7.8,1.3,1.2,0.9,b'1'
113.0,11.1,1.7,0.8,2.3,b'1'
104.0,6.3,2.0,1.2,4.0,b'1'
96.0,9.4,1.5,1.0,3.1,b'1'
120.0,12.4,2.4,0.8,1.9,b'1'
133.0,9.7,2.9,0.8,1.9,b'1'
126.0,9.4,2.3,1.0,4.0,b'1'
113.0,8.5,1.8,0.8,0.5,b'1'
109.0,9.7,1.4,1.1,2.1,b'1'
119.0,12.9,1.5,1.3,3.6,b'1'
101.0,7.1,1.6,1.5,1.6,b'1'
108.0,10.4,2.1,1.3,2.4,b'1'
117.0,6.7,2.2,1.8,6.7,b'1'
115.0,15.3,2.3,2.0,2.0,b'1'
91.0,8.0,1.7,2.1,4.6,b'1'
103.0,8.5,1.8,1.9,1.1,b'1'
98.0,9.1,1.4,1.9,-0.3,b'1'
111.0,7.8,2.0,1.8,4.1,b'1'
107.0,13.0,1.5,2.8,1.7,b'1'
119.0,11.4,2.3,2.2,1.6,b'1'
122.0,11.8,2.7,1.7,2.3,b'1'
105.0,8.1,2.0,1.9,-0.5,b'1'
109.0,7.6,1.3,2.2,1.9,b'1'
105.0,9.5,1.8,1.6,3.6,b'1'
112.0,5.9,1.7,2.0,1.3,b'1'
112.0,9.5,2.0,1.2,0.7,b'1'
98.0,8.6,1.6,1.6,6.0,b'1'
109.0,12.4,2.3,1.7,0.8,b'1'
114.0,9.1,2.6,1.5,1.5,b'1'
114.0,11.1,2.4,2.0,-0.3,b'1'
110.0,8.4,1.4,1.0,1.9,b'1'
120.0,7.1,1.2,1.5,4.3,b'1'
108.0,10.9,1.2,1.9,1.0,b'1'
108.0,8.7,1.2,2.2,2.5,b'1'
116.0,11.9,1.8,1.9,1.5,b'1'
113.0,11.5,1.5,1.9,2.9,b'1'
105.0,7.0,1.5,2.7,4.3,b'1'
114.0,8.4,1.6,1.6,-0.2,b'1'
114.0,8.1,1.6,1.6,0.5,b'1'
105.0,11.1,1.1,0.8,1.2,b'1'
107.0,13.8,1.5,1.0,1.9,b'1'
116.0,11.5,1.8,1.4,5.4,b'1'
102.0,9.5,1.4,1.1,1.6,b'1'
116.0,16.1,0.9,1.3,1.5,b'1'
118.0,10.6,1.8,1.4,3.0,b'1'
109.0,8.9,1.7,1.0,0.9,b'1'
110.0,7.0,1.0,1.6,4.3,b'1'
104.0,9.6,1.1,1.3,0.8,b'1'
105.0,8.7,1.5,1.1,1.5,b'1'
102.0,8.5,1.2,1.3,1.4,b'1'
112.0,6.8,1.7,1.4,3.3,b'1'
111.0,8.5,1.6,1.1,3.9,b'1'
111.0,8.5,1.6,1.2,7.7,b'1'
103.0,7.3,1.0,0.7,0.5,b'1'
98.0,10.4,1.6,2.3,-0.7,b'1'
117.0,7.8,2.0,1.0,3.9,b'1'
111.0,9.1,1.7,1.2,4.1,b'1'
101.0,6.3,1.5,0.9,2.9,b'1'
106.0,8.9,0.7,1.0,2.3,b'1'
102.0,8.4,1.5,0.8,2.4,b'1'
115.0,10.6,0.8,2.1,4.6,b'1'
130.0,10.0,1.6,0.9,4.6,b'1'
101.0,6.7,1.3,1.0,5.7,b'1'
110.0,6.3,1.0,0.8,1.0,b'1'
103.0,9.5,2.9,1.4,-0.1,b'1'
113.0,7.8,2.0,1.1,3.0,b'1'
112.0,10.6,1.6,0.9,-0.1,b'1'
118.0,6.5,1.2,1.2,1.7,b'1'
109.0,9.2,1.8,1.1,4.4,b'1'
116.0,7.8,1.4,1.1,3.7,b'1'
127.0,7.7,1.8,1.9,6.4,b'1'
108.0,6.5,1.0,0.9,1.5,b'1'
108.0,7.1,1.3,1.6,2.2,b'1'
105.0,5.7,1.0,0.9,0.9,b'1'
98.0,5.7,0.4,1.3,2.8,b'1'
112.0,6.5,1.2,1.2,2.0,b'1'
118.0,12.2,1.5,1.0,2.3,b'1'
94.0,7.5,1.2,1.3,4.4,b'1'
126.0,10.4,1.7,1.2,3.5,b'1'
114.0,7.5,1.1,1.6,4.4,b'1'
111.0,11.9,2.3,0.9,3.8,b'1'
104.0,6.1,1.8,0.5,0.8,b'1'
102.0,6.6,1.2,1.4,1.3,b'1'
139.0,16.4,3.8,1.1,-0.2,b'2'
111.0,16.0,2.1,0.9,-0.1,b'2'
113.0,17.2,1.8,1.0,0.0,b'2'
65.0,25.3,5.8,1.3,0.2,b'2'
88.0,24.1,5.5,0.8,0.1,b'2'
65.0,18.2,10.0,1.3,0.1,b'2'
134.0,16.4,4.8,0.6,0.1,b'2'
110.0,20.3,3.7,0.6,0.2,b'2'
67.0,23.3,7.4,1.8,-0.6,b'2'
95.0,11.1,2.7,1.6,-0.3,b'2'
89.0,14.3,4.1,0.5,0.2,b'2'
89.0,23.8,5.4,0.5,0.1,b'2'
88.0,12.9,2.7,0.1,0.2,b'2'
105.0,17.4,1.6,0.3,0.4,b'2'
89.0,20.1,7.3,1.1,-0.2,b'2'
99.0,13.0,3.6,0.7,-0.1,b'2'
80.0,23.0,10.0,0.9,-0.1,b'2'
89.0,21.8,7.1,0.7,-0.1,b'2'
99.0,13.0,3.1,0.5,-0.1,b'2'
68.0,14.7,7.8,0.6,-0.2,b'2'
97.0,14.2,3.6,1.5,0.3,b'2'
84.0,21.5,2.7,1.1,-0.6,b'2'
84.0,18.5,4.4,1.1,-0.3,b'2'
98.0,16.7,4.3,1.7,0.2,b'2'
94.0,20.5,1.8,1.4,-0.5,b'2'
99.0,17.5,1.9,1.4,0.3,b'2'
76.0,25.3,4.5,1.2,-0.1,b'2'
110.0,15.2,1.9,0.7,-0.2,b'2'
144.0,22.3,3.3,1.3,0.6,b'2'
105.0,12.0,3.3,1.1,0.0,b'2'
88.0,16.5,4.9,0.8,0.1,b'2'
97.0,15.1,1.8,1.2,-0.2,b'2'
106.0,13.4,3.0,1.1,0.0,b'2'
79.0,19.0,5.5,0.9,0.3,b'2'
92.0,11.1,2.0,0.7,-0.2,b'2'
125.0,2.3,0.9,16.5,9.5,b'3'
120.0,6.8,2.1,10.4,38.6,b'3'
108.0,3.5,0.6,1.7,1.4,b'3'
120.0,3.0,2.5,1.2,4.5,b'3'
119.0,3.8,1.1,23.0,5.7,b'3'
141.0,5.6,1.8,9.2,14.4,b'3'
129.0,1.5,0.6,12.5,2.9,b'3'
118.0,3.6,1.5,11.6,48.8,b'3'
120.0,1.9,0.7,18.5,24.0,b'3'
119.0,0.8,0.7,56.4,21.6,b'3'
123.0,5.6,1.1,13.7,56.3,b'3'
115.0,6.3,1.2,4.7,14.4,b'3'
126.0,0.5,0.2,12.2,8.8,b'3'
121.0,4.7,1.8,11.2,53.0,b'3'
131.0,2.7,0.8,9.9,4.7,b'3'
134.0,2.0,0.5,12.2,2.2,b'3'
141.0,2.5,1.3,8.5,7.5,b'3'
113.0,5.1,0.7,5.8,19.6,b'3'
136.0,1.4,0.3,32.6,8.4,b'3'
120.0,3.4,1.8,7.5,21.5,b'3'
125.0,3.7,1.1,8.5,25.9,b'3'
123.0,1.9,0.3,22.8,22.2,b'3'
112.0,2.6,0.7,41.0,19.0,b'3'
134.0,1.9,0.6,18.4,8.2,b'3'
119.0,5.1,1.1,7.0,40.8,b'3'
118.0,6.5,1.3,1.7,11.5,b'3'
139.0,4.2,0.7,4.3,6.3,b'3'
103.0,5.1,1.4,1.2,5.0,b'3'
97.0,4.7,1.1,2.1,12.6,b'3'
102.0,5.3,1.4,1.3,6.7,b'3'
